############################
#                          #
#                          #
#                          #
#            A             #
#            a             #
#                          #
#                          #
#                          #
#                          #
#                          #
#                          #
#                          #
############################
