############################
#                          #
#                          #
#                          #
#            B             #
#            a             #
#            A             #
#                          #
#                          #
#                          #
#                          #
#                          #
#                          #
############################
