############################
#                          #
#                          #
#                          #
#            A             #
#   B                      #
#                          #
#                          #
#                          #
#                b         #
#                          #
#     a                    #
#                          #
############################
