############################
#                  B       #
#              b           #
#                 #c#      #
#                  #       #
#    A                     #
#    #                     #
#                          #
#    a                     #
#                          #
#                        C #
#                          #
############################
